___________*_*__*
*********____*_**
*_________*_____*
*_***_*_*_*_*_*_*
*_*_*_*_*_*_*_*_*
*_*_*_*_*__**_***
*_*___*_**_*____/
**__***__*_*__***
*__*____**_**___/
****_*___*_*__***
*____*_*_*_**_*_*
*_**_*_*_*__*___*
***************/*
