*__******
*_*______
*_*_***__
*_*****__
_________
**_______
*_*_*_*__
____*_***
_***____*
____*/***
