*____*_*_***
*__*________
*__*__*_*_**
*__*_*_*****
__*_________
*_*__*______
*__*__*_____
____*_*/____
